cpu : central processing unit, central/main processor / 중앙 처리 장치
exe : execute / 실행하다
e : 자연상수, 오일러 수
exponent : 지수
url : Uniform Resource Locator / 쉽게 말해서, 웹 페이지를 찾기위한 주소
logistic : log 형태
sigmoid : s자 모양의 / sigma
NumPy : Numerical Python
statistics : 통계학 - 기술 : describe (묘사하다)
			  추론 : estimate(추정, 예측)
norm : 표준, 기준, 규범
normalize : 정규화하다
SI : 국제단위계(國際單位系, 프랑스어: Système international d’unités, 영어: International System Units 약칭 SI)
axis : 축
Visual servoing : 비전센서에서 추출한 피드백 정보를 이용하여 로봇의 동작을 제어하는 기술
		       예를 들어 시각처리로 알아낸 정보로 팔을 제어해 과일을 따거나 물건을 잡는 등의 행동
		       나무가지가 과일을 가리면 시점을 바꾸어 손이 닿을 수 있는 경로를 실시간으로 계획
population : 모집단 (어떤 정보를 얻기 위해서 선택 된 집단 전체 또는 특정 연구 결과가 일반화 되어 지는 전체 집단)
population parameter : 모수 (모집단의 특성을 나타내는 수치)

gradient : 편미분, 기울기
ReLU : Rectified Linear Unit
propogation : 전파, 전달
orthogonal : 직각, 직교
diagonal : 대각
PCA : Principal Component Analysis / 주성분 분석, 다변량 분석
standard deviation : 표준 편차
EDA : Exploratory Data Analysis / 탐색적 데이터 분석
analysis : 분석
단위행렬 : Equity | Identity (항등식)
determinant : 행렬식
RNN : Recurrent Neural Network
CNN : Convolutional Neural Network / 합성곱 신경망
KNN : K-Nearest Neighbor / K-최근접 이웃
GAN : Generative Adversarial Networks / 적대적 생성 신경망, 생산적 적대 신경망
variance : 분산
Advanced Package Tool
one hot encoding : 범주형 데이터를 표현하는 유사한 기술
척도 - 명목  -
                    |  -  범주형 데이터(categorical)
       - 서열  -

       - 등간  -
                    |  -  연속형 데이터(continuous)
       - 비율  -

attribute, property : 속성
transpose : 전치 (행과 열을 교환)
rmse : root mean square error
entropy : 균형, 불확실성의 정도
cross entropy : 교차 엔트로피 / 분류
probability : 확률
distribution : 분포
missing value : 결측치
aggregate : 집계 (집계함수: count, sum, average, min, max)
ordinary : 보통의, 일상적인
csv : comma separated value
feature : 특성, 특징
summary : 요약, 개요
SQL : Structured Query Language / 관계형 데이터베이스 관리 시스템의 데이터를 관리하기 위해 설계한 특수 목적의 프로그래밍 언어
integration : 통합
imputation : 대체
churn :  이탈한 고객을 측정하는 지표
likelihood : 우도, 가능도
permutation : 순열
combination : 조합
odds : 배당률
GPT : Generative pre-trained transformer
LLM : Large Language Models / 대규모 언어 모델
diffusion : 확산, 발산
AI : artificial intelligence / 인공지능
AGI : artificial general intelligence / 강인공지능
TPE : Task(작업) Performance(성능) Experience(경험)
pmf : probability mass function / 확률질량함수
pdf : probability dense function / 확률밀도함수
intercept : y절편
hypothesis : 가설 함수
null hypothesis : 귀무가설 / H0
연구가설(research hypothesis), 대립가설(antihypothesis) / H1
defect : 불량, 결함
detection : 감지
gradient descent : 경사하강법
Adaline : Adaptive Linear Neuron | 적응형 선형 뉴런 / 퍼센트론의 향상된 버전
deprecate : 반대, 불찬성, 항의; 애원, 탄원
cm : colormap
accuracy : 정확, 정확도
predict : 예측(예견)하다
prediction : 예측, 예견

hsv : 색을 표현하는 방법의 하나이다. RGB 와는 다르게 색을 나타내는 방법으로, 색조(Hue), 채도(Saturation), 명도(Value)의 3요소로 구성된다. HSB(Brightness)라는 표기도 쓰인다.

Sequential : 순차적인
k-fold cross validation : k겹 교차 검증
augment : 증강
HDF5 : Hierarchical Data Format / 고성능 데이터포맷 또는 DB 
distance : 거리
polynomial : 다항의
decision : 결정, 판단
complexity : 복잡함, 복잡도

Stochastic gradient descent : 확률 경사 하강법
support vector machine : 두 카테고리 중 어느 하나에 속한 데이터의 집합이 주어졌을 때, SVM 알고리즘은 주어진 데이터 집합을 바탕으로 하여 새로운 데이터가 어느 카테고리에 속할지 판단하는 비확률적 이진 선형 분류 모델을 만든다.

criterion : (판단이나 결정을 위한) 기준
Information Gain(IG) : 정보 이득
pruning : 가지치기
impurity : 불순도
significant : 유의미한, 중요한
ensemble : 전체적인 어울림이나 통일, 앙상블
배깅(Bagging, Bootstrap aggregating) : 부트스트랩(Bootstrap)을 통해서 다양한 데이터셋을 만들고 이를 학습시킨 모델을 모으는(Aggregating) 방법

